league,season,team,tackles,tackles_won,tackles_def_3rd,tackles_mid_3rd,tackles_att_3rd,dribble_tackles,dribbles_vs,dribble_tackles_pct,dribbled_past,blocks,blocked_shots,blocked_passes,interceptions,clearances,errors
ITA-Serie A,2122,vs Atalanta,683,407,385,234,64,307,679,45.2,372,515,184,331,429,721,8
ITA-Serie A,2122,vs Bologna,574,321,237,231,106,272,598,45.5,326,383,108,275,376,618,8
ITA-Serie A,2122,vs Cagliari,488,275,209,212,67,227,479,47.4,252,390,117,273,306,637,9
ITA-Serie A,2122,vs Empoli,590,361,283,215,92,255,546,46.7,291,434,142,292,377,706,7
ITA-Serie A,2122,vs Fiorentina,515,289,264,191,60,240,541,44.4,301,386,119,267,351,687,4
ITA-Serie A,2122,vs Genoa,651,370,277,304,70,278,580,47.9,302,418,105,313,350,736,7
ITA-Serie A,2122,vs Hellas Verona,659,367,305,287,67,276,589,46.9,313,425,117,308,425,569,16
ITA-Serie A,2122,vs Inter,461,251,230,172,59,216,471,45.9,255,447,172,275,395,832,8
ITA-Serie A,2122,vs Juventus,582,334,277,224,81,270,637,42.4,367,389,120,269,364,570,12
ITA-Serie A,2122,vs Lazio,547,319,243,223,81,274,608,45.1,334,351,89,262,399,621,14
ITA-Serie A,2122,vs Milan,635,352,318,250,67,323,779,41.5,456,431,158,273,356,722,16
ITA-Serie A,2122,vs Napoli,532,320,248,220,64,238,595,40.0,357,455,155,300,397,613,19
ITA-Serie A,2122,vs Roma,586,361,290,226,70,299,630,47.5,331,402,165,237,383,722,5
ITA-Serie A,2122,vs Salernitana,602,341,267,244,91,272,586,46.4,314,373,114,259,315,702,12
ITA-Serie A,2122,vs Sampdoria,464,276,177,196,91,194,422,46.0,228,410,108,302,363,631,7
ITA-Serie A,2122,vs Sassuolo,661,371,286,271,104,275,678,40.6,403,440,154,286,374,573,12
ITA-Serie A,2122,vs Spezia,607,366,270,234,103,254,546,46.5,292,388,105,283,334,514,7
ITA-Serie A,2122,vs Torino,502,284,267,190,45,216,511,42.3,295,390,123,267,300,625,9
ITA-Serie A,2122,vs Udinese,650,363,301,254,95,316,679,46.5,363,390,126,264,340,611,9
ITA-Serie A,2122,vs Venezia,589,341,251,246,92,276,576,47.9,300,377,82,295,370,560,5
ITA-Serie A,2223,vs Atalanta,742,458,420,245,77,355,695,51.1,340,454,133,321,360,704,9
ITA-Serie A,2223,vs Bologna,548,325,255,220,73,243,508,47.8,265,455,117,338,320,571,10
ITA-Serie A,2223,vs Cremonese,548,331,253,216,79,251,488,51.4,237,384,120,264,307,706,13
ITA-Serie A,2223,vs Empoli,683,387,316,265,102,311,624,49.8,313,457,130,327,330,632,8
ITA-Serie A,2223,vs Fiorentina,618,339,338,227,53,273,596,45.8,323,448,176,272,331,844,12
ITA-Serie A,2223,vs Hellas Verona,604,346,304,231,69,275,549,50.1,274,378,105,273,272,694,4
ITA-Serie A,2223,vs Inter,461,262,213,183,65,200,416,48.1,216,373,149,224,330,802,10
ITA-Serie A,2223,vs Juventus,605,349,281,238,86,255,546,46.7,291,387,132,255,362,702,9
ITA-Serie A,2223,vs Lazio,529,301,219,242,68,239,524,45.6,285,405,107,298,329,537,15
ITA-Serie A,2223,vs Lecce,574,327,305,211,58,245,485,50.5,240,374,117,257,306,691,7
ITA-Serie A,2223,vs Milan,644,381,345,235,64,324,692,46.8,368,421,140,281,335,788,13
ITA-Serie A,2223,vs Monza,546,323,222,235,89,237,519,45.7,282,377,105,272,316,555,6
ITA-Serie A,2223,vs Napoli,700,406,403,226,71,361,698,51.7,337,436,161,275,331,726,14
ITA-Serie A,2223,vs Roma,633,388,303,253,77,315,589,53.5,274,399,138,261,290,621,11
ITA-Serie A,2223,vs Salernitana,564,331,225,257,82,261,525,49.7,264,372,96,276,299,564,8
ITA-Serie A,2223,vs Sampdoria,557,354,244,234,79,222,482,46.1,260,431,99,332,317,649,5
ITA-Serie A,2223,vs Sassuolo,634,360,319,244,71,270,569,47.5,299,426,124,302,306,625,10
ITA-Serie A,2223,vs Spezia,669,367,314,257,98,303,581,52.2,278,430,117,313,354,749,6
ITA-Serie A,2223,vs Torino,590,312,309,234,47,276,579,47.7,303,407,122,285,306,626,5
ITA-Serie A,2223,vs Udinese,686,389,341,251,94,350,680,51.5,330,438,146,292,301,593,11
ITA-Serie A,2324,vs Atalanta,647,414,330,249,68,270,556,48.6,286,457,125,332,340,704,12
ITA-Serie A,2324,vs Bologna,633,377,282,259,92,322,615,52.4,293,514,131,383,306,554,15
ITA-Serie A,2324,vs Cagliari,558,327,275,213,70,220,457,48.1,237,355,110,245,251,809,8
ITA-Serie A,2324,vs Empoli,589,334,286,243,60,285,511,55.8,226,396,126,270,261,674,9
ITA-Serie A,2324,vs Fiorentina,608,382,323,218,67,277,556,49.8,279,440,147,293,272,887,14
ITA-Serie A,2324,vs Frosinone,697,407,365,265,67,349,646,54.0,297,427,120,307,302,620,18
ITA-Serie A,2324,vs Genoa,493,298,230,198,65,200,393,50.9,193,339,88,251,271,677,11
ITA-Serie A,2324,vs Hellas Verona,545,307,248,242,55,261,513,50.9,252,350,89,261,215,656,15
ITA-Serie A,2324,vs Inter,420,231,206,161,53,190,385,49.4,195,435,141,294,291,803,11
ITA-Serie A,2324,vs Juventus,576,319,271,227,78,269,528,50.9,259,408,150,258,273,741,12
ITA-Serie A,2324,vs Lazio,512,303,239,211,62,269,541,49.7,272,441,122,319,318,702,16
ITA-Serie A,2324,vs Lecce,636,381,286,270,80,279,578,48.3,299,369,137,232,274,667,14
ITA-Serie A,2324,vs Milan,617,370,292,239,86,324,683,47.4,359,397,138,259,270,687,6
ITA-Serie A,2324,vs Monza,481,304,211,199,71,216,432,50.0,216,405,133,272,259,594,4
ITA-Serie A,2324,vs Napoli,637,393,351,215,71,344,671,51.3,327,443,179,264,285,823,10
ITA-Serie A,2324,vs Roma,489,321,217,190,82,218,439,49.7,221,410,128,282,282,753,7
ITA-Serie A,2324,vs Salernitana,573,349,243,258,72,269,481,55.9,212,407,115,292,294,629,7
ITA-Serie A,2324,vs Sassuolo,584,340,271,240,73,252,529,47.6,277,358,131,227,285,752,12
ITA-Serie A,2324,vs Torino,519,311,255,220,44,247,491,50.3,244,344,114,230,291,702,3
ITA-Serie A,2324,vs Udinese,649,394,302,250,97,314,650,48.3,336,368,127,241,249,582,11
ITA-Serie A,2425,vs Atalanta,692,399,381,244,67,330,587,56.2,257,387,125,262,330,895,28
ITA-Serie A,2425,vs Bologna,627,375,320,253,54,266,487,54.6,221,391,136,255,305,999,22
ITA-Serie A,2425,vs Cagliari,568,338,270,220,78,274,502,54.6,228,396,117,279,268,920,16
ITA-Serie A,2425,vs Como,648,385,260,287,101,288,552,52.2,264,453,139,314,325,757,28
ITA-Serie A,2425,vs Empoli,587,373,271,250,66,238,450,52.9,212,355,110,245,255,918,17
ITA-Serie A,2425,vs Fiorentina,560,316,260,222,78,254,524,48.5,270,349,111,238,237,770,27
ITA-Serie A,2425,vs Genoa,549,326,230,255,64,260,447,58.2,187,367,98,269,284,854,22
ITA-Serie A,2425,vs Hellas Verona,487,263,242,179,66,233,461,50.5,228,337,101,236,221,734,18
ITA-Serie A,2425,vs Inter,441,265,193,184,64,199,357,55.7,158,392,144,248,259,887,19
ITA-Serie A,2425,vs Juventus,593,359,265,239,89,300,609,49.3,309,383,144,239,298,797,21
ITA-Serie A,2425,vs Lazio,576,332,263,225,88,266,562,47.3,296,356,134,222,272,985,24
ITA-Serie A,2425,vs Lecce,538,327,226,229,83,248,485,51.1,237,375,106,269,292,807,23
ITA-Serie A,2425,vs Milan,597,339,309,224,64,309,652,47.4,343,364,160,204,291,803,23
ITA-Serie A,2425,vs Monza,561,336,206,257,98,227,447,50.8,220,312,77,235,225,768,11
ITA-Serie A,2425,vs Napoli,612,366,300,238,74,286,530,54.0,244,446,160,286,330,845,26
ITA-Serie A,2425,vs Parma,573,354,293,216,64,276,525,52.6,249,330,112,218,279,739,13
ITA-Serie A,2425,vs Roma,549,328,278,202,69,266,476,55.9,210,398,150,248,261,838,19
ITA-Serie A,2425,vs Torino,508,293,219,218,71,236,405,58.3,169,334,115,219,289,887,22
ITA-Serie A,2425,vs Udinese,589,350,275,238,76,294,575,51.1,281,326,109,217,270,887,15
ITA-Serie A,2425,vs Venezia,688,420,284,296,108,290,538,53.9,248,361,104,257,304,823,22
ITA-Serie A,2526,vs Atalanta,40,21,15,21,4,21,59,35.6,38,31,10,21,25,78,4
ITA-Serie A,2526,vs Bologna,43,28,19,22,2,17,35,48.6,18,36,11,25,21,68,1
ITA-Serie A,2526,vs Cagliari,42,28,15,22,5,17,31,54.8,14,26,7,19,18,38,2
ITA-Serie A,2526,vs Como,70,43,36,27,7,37,65,56.9,28,41,13,28,30,64,1
ITA-Serie A,2526,vs Cremonese,30,20,15,13,2,12,29,41.4,17,23,5,18,16,75,2
ITA-Serie A,2526,vs Fiorentina,33,23,20,8,5,15,34,44.1,19,24,12,12,15,81,1
ITA-Serie A,2526,vs Genoa,56,27,16,30,10,23,55,41.8,32,33,11,22,24,67,1
ITA-Serie A,2526,vs Hellas Verona,30,18,11,14,5,21,45,46.7,24,24,9,15,21,77,6
ITA-Serie A,2526,vs Inter,35,17,15,15,5,16,34,47.1,18,29,11,18,13,100,5
ITA-Serie A,2526,vs Juventus,42,23,18,17,7,22,42,52.4,20,35,13,22,18,58,0
ITA-Serie A,2526,vs Lazio,65,42,38,16,11,29,51,56.9,22,40,12,28,31,65,2
ITA-Serie A,2526,vs Lecce,55,37,32,16,7,29,42,69.0,13,22,12,10,21,63,1
ITA-Serie A,2526,vs Milan,46,29,28,17,1,35,61,57.4,26,33,15,18,12,71,5
ITA-Serie A,2526,vs Napoli,45,28,21,16,8,18,40,45.0,22,35,14,21,22,70,4
ITA-Serie A,2526,vs Parma,52,31,28,16,8,20,36,55.6,16,23,11,12,29,106,2
ITA-Serie A,2526,vs Pisa,41,22,17,16,8,21,38,55.3,17,25,7,18,17,86,2
ITA-Serie A,2526,vs Roma,59,36,29,26,4,29,54,53.7,25,31,11,20,21,99,3
ITA-Serie A,2526,vs Sassuolo,45,28,20,19,6,21,39,53.8,18,21,3,18,19,45,1
ITA-Serie A,2526,vs Torino,37,19,21,11,5,14,31,45.2,17,19,7,12,23,52,2
ITA-Serie A,2526,vs Udinese,48,27,27,16,5,19,39,48.7,20,32,11,21,19,67,3
